########################################
#...........###...............###......#
#..#####....###...............###......#
#..#...#......................###......#
#..#...#...............#####...........#
#..#...#...............#...............#
#..#####...............#...............#
#......................#...............#
#......................#...............#
t..............o.......#...............t
#......................#...............#
#......................#...............#
#...............########...............#
#...............#......................#
#...............#......................#
#...............#......................#
#...............###..............####..#
#...............###..............#.....#
#...............................###....#
########################################