########################################
########################################
########################################
########################################
########################################
########################################
########################################
########################################
########################################
#P.....................................#
########################################
########################################
########################################
########################################
########################################
###############FFFF#####################
########################################
########################################
########################################
########################################